NO ./path_to_the_north_texture
SO ./path_to_the_south_texture
WE ./path_to_the_west_texture
EA ./path_to_the_east_texture
F 220,100,0
C 225,30,0
        1111111
   1111111111111111111111111
   1000000000110000000000001
   1011000001110000000000001
   1001000000000000000000001
   111111111011000001110000111111111
   10000000001100000111011111101
   11110111111111011100000010001
   11110111111111011101010010001
111110000001101010111000000100011111111
   10000000000000001100000010001
   1000000000000000110101001000111111
11111000001110101011111011110001
   11110111 1110101 101111010N011111111
11111111111 1111111 111111111111
                               1
                               1
