R 1080 720
NO assets/images/no_redbrick.xpm
SO assets/images/so_redbrick.xpm
EA assets/images/ea_redbrick.xpm
WE assets/images/we_redbrick.xpm
C 255,200,160
F 122,122,1

1111111111111111
1000000000000001
1000000000000001
10000000N0000001
1000000000000001
1111111111111111
