

    11111                                                          1111111111111
    10001                                                          1000000000001
    10001                    1                                     1000000000001
    10001111111              11111111111111111                     1000000000001
    1         11                              1       11111111111111000000000001
    1          11111                          1       10000000000001000000000001
    1              1                          1       1            1000000000001
    1              1                          111111111            1000000000001
    1                                                                          1111
    1                                                                             1
    1                                                                             1
   11                                                                             1
   1                                                                              1
   11                                                                             1
    1                                               111111111111111               1
    1                                               1             1               1
    1                                               1             1              11
    1                                               1             1             11
   11                                               1             1             1
   1                                                1             1             1
   1                                                1             1             1
   1                                                1             1             1
   1                                                1             1             1
   1111                                             1             1             1
      1001                                          1             1             1
      1001                                          1             1             1
      1001                            111111111111111             1             1
      1001                           11                           1             1
      1001                           1              111111111111111             1
      1001                           1              1                           1
    111  1111111                     1              1                           1
    1          1                     1              1                           11111
    1          1                     1              1                               1
    1                    1111111PP1111              1                               1
    1                    1           1              1                               1
    1                   11  11       1              1                               1
    1               11111   1        1              1                               1
    1111111111              1        1              1                               1
             111    111111111        1              11  111111                      1
               100111                1              1    1   1                      1
               1001                  1              1    1   1                      1
               1001                  11             1    1   1                      1
               1001                   1111111111111 1    1   1                      1
               1001                               1 1    1   1                      1
               1001                               1 1    1   1                      1
           11111                                  1 1    1   1                      1
           1                                     1111    1   1                 111111
           1                                       1100001   1111111    1      1
           1                                                       1111111111111
           1                                                       1
           1                                                       1
           1                                                       1
           1                                                       1
           1                                                       1
           1                                                       1
        1111                                                       1
        1                                                          1
        1                                                          1
        1                                                          1
        1                                                   1111   1
        1                                                   1  11111
        1                                                   1
        1                                                   1
       11                                                   111
      11                                                      1
     11                                                       1
     1                                                        1
     1                                                        1
     1                                                        1
     1                                                        1
     1                                                        1
     1                                                        1
     1                                                 11111111
     1111111111111111             1111111111111        1
                    111111111111111           1        1
                                              1111111111
