NO assets/images/no_redbrick.xpm
SO assets/images/so_redbrick.xpm
EA assets/images/ea_redbrick.xpm
WE assets/images/we_redbrick.xpm
C 125,65,160
F 122,122,1

  111111
  10nn01                                              1111111111111
  1bbbb111111111                                      1000000000001
  10000000000001111111                   11111111111111000000000001
  1000n00000000100000111111111111    111110000000000000000000000001
  10000000000001000000000000000011111100010000000000000000000000001
1111000000n00000000000000000000000n00n00010000000000000000000000001111
10000000000000010000000000000n0000nnnn000D0000000000000000000000000001
1000000000000001000000000000000000000000010000000000000000000000000001
1100000000000001111111111111101111111111110000011111111111100000000001
1100000000000011            101          1000001          100000000011
111100111000111  111111111111D111 111111 1000001          100000001111
1111001111111    1000000000000001110000111000001          100000001
110000000011111111000000000000000000000000000001          100000001
1100000000000000000001111111110000011111111111111111111111100000001
1100000000000000000001       1000001         1000000000000000000001111
1111111000001111111111       1000001         1000000000000000000000001
     11111011111           111000001         1000000000000000000000001
   11100000000011          100000001         1000bn1110000000000000001
   100000000000011       111000000011111111111000bb1 10000000000000001
   100000000000001       10n000000000000000000000001 10000000000000001
   100000000000001       110000011111110000000100001 10000010000000001
   100000000000001        1111011     10000000000001 11111111111111111
  1100000000000111           1011     10000000000001
  1000000000000111111111     101      10000000000001
 11000000000000000000001     1011    110000000000001
 11000000000000000000001     10011111100000011111111
11000000000000000000000111111100000000000000111
10000000nnnnnnnnn000000000000000000000000000001
10000000nnnnnnnnn00000000000N000000000000000001
10000000000000000000000000000000000000000000001
11111111111111111111111111111111111111111111111
