NO assets/images/no_redbrick.xpm
SO assets/images/so_redbrick.xpm
EA assets/images/ea_redbrick.xpm
WE assets/images/we_redbrick.xpm
C 125,65,160
F 122,122,1

      11111111111111111111111111111111111111111111111111111111111111111111111111
      10000111111111111111111111111111111111111111111111111111111111111111111111
      10000111111111111111111111111111111111111111111111111111000000000001111111
      10000000000000111111111111111111111111111111111111111111000000000001111111
      10000000000000000000111111111111111111111110000000000000000000000001111111
      10000000000000000000000000000000011111100010000000000000000000000001111111
11111110000000000000000000000000000000011111100010000000000000000000000001111111
11111000000000000000000000000000000000000000000010000000000000000000000000001111
11111000000000000000000000000000000000000000000010000000000000000000000000001111
11111100000000000000111111111111110000011111111110000011111111111100000000001111
11111100000000000001111111111111110000011111111110000011111111111100000000011111
11111111000111000111111111111111110000011111111110000011111111111100000001111111
11111111000111111111111000000000000000011100001110000011111111111100000001111111
11111100000000011111111000000000000000000000000000000011111111111100000001111111
11111100000000000000000000111111111000000011111111111111111111111100000001111111
11111100000000000000000000111111111000000011111111111000000000000000000001111111
11111111111000000111111111111111111000000011111111111000000000000000000000001111
11111111111111001111111111111111111HHHH00011111111111000000000000000000000001111
11111111110000000000111111111111100000000011111111111000001110000000000000001111
11111111000000000000011111111111100000000011111111111000001110000000000000001111
11111111000000000000001111111110000000000000000000000000001110000000000000001111
11111111000000000000001111111111000000011111110000000100001110000010000001111111
11111111000000000000001111111111111000111111110000000000001111111111111111111111
11111111000000000000111111111111111000111111110000000000001111111111111111111111
11111110000000000000111101111111111000111111110000000000001111111111111111111111
11111110000000000000000000001111111DDD111111110000000000001111111111111111111111
11111110000000000000000000001111111000011111100000011111111111111111111111111111
11111100000000000000000000001111111000000000000000011111111111111111111111111111
11111000000000000000000000000000000000000000000000000111111111111111111111111111
11111000000000000000000000000000000000000000000000000111111111111111111111111111
1111100000000000000000000000000000000000000000000000W111111111111111111111111111
11111111111111111111111111111111111111111111111111111111111111111111111111111111
