NO assets/images/no_redbrick.xpm
SO assets/images/so_redbrick.xpm
EA assets/images/ea_redbrick.xpm
WE assets/images/we_redbrick.xpm
C 57, 56, 57
F 110,109,110

1111111111111111111111111111111111111111
1000000000000000000000000000000000000001
1000000000000000000000000000000000000001
1000000000000000000000000000000000000001
1000000000000000000000000000000000000001
1000000000000000000000000000000000000001
1000001000000000100000000000100000000001
1000001000000000100000000000100000000001
1000001000000000100000000000100000000001
1000001000000000100000000000100000000001
1000001000000000100000000000100000000001
1000001000000000100000000000100000000001
1000001000000000100011111100100000000001
100000100000000010001    100100000000001
100000100000000010001    100100000000001
100000100000000010001    100100000000001
1000001000000000100011111100100000000001
10000010000000001000a0000000100000000001
100000100000000010c0000d0000100000000001
1000001000000000D000N00000001000b0000001
10000010000000001a0000000000100000000001
1000001000000000100000000000100000000001
100000100000000010001D111000100000000001
1000001000000000100000000000100000000001
1000001000000000100000000000100000000001
1000001000000000100000000000100000000001
1000001000000000100000000000100000000001
1000001000000000100000000000100000000001
1000001000000000100000000000100000000001
1000001000000000100000000000100000000001
1000001000000000100000000000100000000001
1000001000000000100000000000100000000001
1000000000000000000000000000000000000001
1000000000000000000000000000000000000001
1000000000000000000000000000000000000001
1000000000000000000000000000000000000001
1000000000000000000000000000000000000001
1000000000000000000000000000000000000001
1000000000000000000000000000000000000001
1000000000000000000000000000000000000001
1000000000000000000000000000000000000001
1111111111111111111111111111111111111111
