NO assets/images/no_redbrick.xpm
SO assets/images/so_redbrick.xpm
EA assets/images/ea_redbrick.xpm
WE assets/images/we_redbrick.xpm
C 0,220,255
F 255,100,0

1111111111111111111111111111111111111111
1000000000000000000000000000000000000001
1000000000000000000000000000000000000001
1000000000000000000000000000000000000001
1000000000000000000000000000000000000001
1000000000000000000000000000000000000001
1000001000000000100000000000100000000001
1000001000000000100000000000100000000001
1000001000000000100000000000100000000001
1000001000000000100000000000100000000001
1000001000000000100000000000100000000001
1000001000000000100000000000100000000001
1000001000000000100011111100100000000001
100000100000000010001    100100000000001
100000100000000010001    100100000000001
100000100000000010001    100100000000001
1000001000000000100011111100100000000001
1000001000000000100000000000100000000001
1000001000000000100000000000100000000001
1000001000000000100000000000100000000001
1000001000000000100000000000100000000001
1000001000000000100000000000100000000001
1000001000000000100000000000100000000001
1000001000000000100000000000100000000001
1000001000000000100000000000100000000001
1000001000000000100000000000100000000001
1000001000000000100000000000100000000001
1000001000000000100000000000100000000001
1000001000000000100000000000100000000001
1000001000000000100000000000100000000001
1000001000000000100000000000100000000001
1000001000000000100000000000100000000001
1000000000000000000000000000000000000001
1000000000000000000000000000000000000001
1000000000000000000000000000000000000001
1000000000000000000000000000000000000001
1000000000000000000000000000000000000001
1000000000000000000000000000000000000001
1000000000000000000000000000000000000001
1000000000000000000000000000000000000001
1N00000000000000000000000000000000000001
1111111111111111111111111111111111111111
