NO assets/images/no_redbrick.xpm
SO assets/images/so_redbrick.xpm
EA assets/images/ea_redbrick.xpm
WE assets/images/we_redbrick.xpm
C 57, 56, 57
F 110,109,110

1111111111111111111111111111111111111111
1000000000000000000000000000000000000001
10000c00cccc0000000000100000000000000001
1000000000000000010001D10000000000000001
10000000000000000D00000000000001D1000001
1000000000000000010000000000000000000001
10000010000000001000001D1000100000000001
1000001000000000100000000000100000000001
100000100000000010m000000000100000000001
1000001000000000100000000000100000000001
1000001000000000100000000000100000000001
1000001000000000100000000000100000000001
1000001000000000100011111100100000000001
100000100000000010001    100100000000001
100000100000000010001    100100000000001
100000100000000010001    100100000000001
1000001000000000100011111100100000000001
10000010000000001000a0000000100000000001
100000100000000010c0000d0e00100000000001
1000001000000000D000N00000001000b0000001
10000010000000001a0000000000100000000001
1000001000000000100000000000100000000001
100000100000000010001D111000100000000001
1000001000000000100000000000100000000001
1000001000000000100000000000100000000001
1000001000000000100000000000100000000001
1000001000000000100000000000100000000001
1000001000000000100000000000100000000001
1000001000000000100000000000100000000001
1000001000000000100000000000100000000001
1000001000000000100000000000100000000001
1000001000000000100000000000100000000001
1000000000000000000000000000000000000001
1000000000000000000000000000000000000001
1000000000000000000000000000000000000001
1000000000000000000000000000000000000001
1000000000000000000000000000000000000001
1000000020304050607000000000000000000001
1000000020304050607000000000000000000001
1000000000000000000000000000000000000001
100000a0b0c0d0e0f0g0h0000m0n0m0n00000001
1111111111111111111111111111111111111111
