NO assets/images/blue_block.xpm
SO assets/images/blue_block.xpm
EA assets/images/blue_block.xpm
WE assets/images/blue_block.xpm
C 57, 56, 57
F 111, 110, 111

1111111111111111111111111111111111111111111111111
1000D000060000D000030000D000070000D000010000D0001
10001000060000500003000040000700005m00m1n00n30001
1e0e1f00f6gnmh5b00b3d00d4c00c7a00a5m00m1n00n3mmm1
1n0n10mm0600005n00n3000040000700005m00m1n00n30001
1000100006000050000300004mmmm700005m00m1n00n30001
10001000060000500003nnnn400007n00n5m00m1n00n30001
10001000060000500003000040000700005m00m1n00n36D61
1e0e1f00f6gnmh5b00b3d00d4c00c7a00a5m00m1n00n30001
1n0n10mm0600005n00n3000040000700005m00m1n00n30001
10001000060000500003000040000700005m00m1n00n30001
10001000060000500003000040000700005m00m1n00n35n51
10001000060000500003nnnn4mmmm7n00n5m00m1n00n30001
10001000060000500003000040000700005m00m1n00n30001
10001000060000500003000040000700005m00m1n00n30001
1e0e1f00f6gnmh5b00b3d00d4c00c7a00a5m00m1n00n30001
1n0n10mm0600005n00n3000040000700005m00m1n00n36D61
10001000060000500003000040000700005m00m1n00n30001
1000100006000050000300004mmmm700005m00m1n00n30001
10001000060000500003nnnn40000700005m00m1n00n30001
100010000600005000030000400007n00n5m00m1n00n3nnn1
1e0e1f00f6gnmh5b00b3d00d4c00c7a00a5m00m1n00n3d0d1
100010mm0600005n00n3000040000700005m00m1n00n35651
10N010000D000050000D00004aa00D00005m00mDn00n30001
1111111111111111111111111111111111111111111111111
